1111111111111
1001CCCCCCCC1
1000011110001
1P0011E001001
1111111111111
